[multiqc.modules.v1]
rna_seqc = multiqc.modules.rna_seqc:MultiqcModule
theta2 = multiqc.modules.theta2:MultiqcModule
peddy = multiqc.modules.peddy:MultiqcModule
hicexplorer = multiqc.modules.hicexplorer:MultiqcModule
fastqc = multiqc.modules.fastqc:MultiqcModule
sargasso = multiqc.modules.sargasso:MultiqcModule
vcftools = multiqc.modules.vcftools:MultiqcModule
snpeff = multiqc.modules.snpeff:MultiqcModule
deeptools = multiqc.modules.deeptools:MultiqcModule
goleft_indexcov = multiqc.modules.goleft_indexcov:MultiqcModule
verifybamid = multiqc.modules.verifybamid:MultiqcModule
star = multiqc.modules.star:MultiqcModule
clipandmerge = multiqc.modules.clipandmerge:MultiqcModule
busco = multiqc.modules.busco:MultiqcModule
samtools = multiqc.modules.samtools:MultiqcModule
kallisto = multiqc.modules.kallisto:MultiqcModule
hisat2 = multiqc.modules.hisat2:MultiqcModule
picard = multiqc.modules.picard:MultiqcModule
rseqc = multiqc.modules.rseqc:MultiqcModule
dedup = multiqc.modules.dedup:MultiqcModule
quast = multiqc.modules.quast:MultiqcModule
interop = multiqc.modules.interop:MultiqcModule
bbmap = multiqc.modules.bbmap:MultiqcModule
samblaster = multiqc.modules.samblaster:MultiqcModule
gatk = multiqc.modules.gatk:MultiqcModule
preseq = multiqc.modules.preseq:MultiqcModule
rsem = multiqc.modules.rsem:MultiqcModule
hicup = multiqc.modules.hicup:MultiqcModule
jellyfish = multiqc.modules.jellyfish:MultiqcModule
qualimap = multiqc.modules.qualimap:MultiqcModule
conpair = multiqc.modules.conpair:MultiqcModule
sortmerna = multiqc.modules.sortmerna:MultiqcModule
featureCounts = multiqc.modules.featureCounts:MultiqcModule
qorts = multiqc.modules.qorts:MultiqcModule
adapterRemoval = multiqc.modules.adapterRemoval:MultiqcModule
flexbar = multiqc.modules.flexbar:MultiqcModule
salmon = multiqc.modules.salmon:MultiqcModule
supernova = multiqc.modules.supernova:MultiqcModule
disambiguate = multiqc.modules.disambiguate:MultiqcModule
prokka = multiqc.modules.prokka:MultiqcModule
fastq_screen = multiqc.modules.fastq_screen:MultiqcModule
methylQA = multiqc.modules.methylQA:MultiqcModule
htseq = multiqc.modules.htseq:MultiqcModule
bismark = multiqc.modules.bismark:MultiqcModule
cutadapt = multiqc.modules.cutadapt:MultiqcModule
bamtools = multiqc.modules.bamtools:MultiqcModule
bowtie1 = multiqc.modules.bowtie1:MultiqcModule
trimmomatic = multiqc.modules.trimmomatic:MultiqcModule
bowtie2 = multiqc.modules.bowtie2:MultiqcModule
homer = multiqc.modules.homer:MultiqcModule
bcl2fastq = multiqc.modules.bcl2fastq:MultiqcModule
slamdunk = multiqc.modules.slamdunk:MultiqcModule
leehom = multiqc.modules.leehom:MultiqcModule
biobloomtools = multiqc.modules.biobloomtools:MultiqcModule
clusterflow = multiqc.modules.clusterflow:MultiqcModule
afterqc = multiqc.modules.afterqc:MultiqcModule
macs2 = multiqc.modules.macs2:MultiqcModule
skewer = multiqc.modules.skewer:MultiqcModule
tophat = multiqc.modules.tophat:MultiqcModule
custom_content = multiqc.modules.custom_content:custom_module_classes
bcftools = multiqc.modules.bcftools:MultiqcModule

[multiqc.templates.v1]
default = multiqc.templates.default
sections = multiqc.templates.sections
default_dev = multiqc.templates.default_dev
geo = multiqc.templates.geo
simple = multiqc.templates.simple

